30 30
--LAYER 0--
5 5 5 5 5 5 5 5 5 5 5 0 5 5 5 5 5 0 0 0 0 0 0 5 5 5 5 5 5 5 
5 5 5 5 5 5 5 5 5 5 5 5 5 5 5 5 5 3 4 4 4 4 4 3 5 5 5 5 5 5 
5 5 5 3 4 3 5 3 4 3 5 5 5 5 5 5 3 4 24 24 24 24 24 4 4 4 3 5 5 5 
5 5 5 3 24 4 4 4 24 4 3 5 5 5 5 5 3 24 24 24 25 24 24 24 24 24 4 3 5 5 
5 5 3 4 24 24 24 24 24 24 4 4 4 4 4 3 3 3 24 24 24 24 24 25 24 24 24 3 5 5 
5 5 3 24 24 24 27 24 24 24 24 24 24 24 24 3 3 3 24 24 24 26 24 24 24 24 24 4 3 5 
5 5 3 3 24 24 24 24 24 24 26 24 24 24 3 3 3 3 3 24 24 24 24 24 24 24 24 24 4 3 
5 5 4 3 24 26 24 24 27 24 25 24 24 24 3 3 3 3 3 24 25 24 24 24 24 24 25 24 24 3 
5 5 5 3 24 24 24 24 24 24 24 24 24 3 3 3 3 3 3 24 24 24 24 24 24 24 24 24 24 3 
5 5 5 3 24 25 24 24 24 24 24 24 3 3 3 4 4 3 3 24 24 25 24 24 25 24 24 24 3 4 
5 5 3 4 24 24 24 24 27 24 24 24 4 4 4 24 24 4 4 24 24 27 24 24 24 24 24 3 3 5 
5 5 3 24 24 24 26 24 24 26 24 24 24 26 24 25 24 24 26 26 24 24 24 24 24 24 3 3 4 5 
5 5 3 3 24 24 24 24 24 24 24 3 4 4 4 4 4 4 4 4 3 24 24 24 24 3 3 3 5 5 
5 5 4 3 3 3 3 3 3 24 3 4 24 24 24 24 24 24 24 24 4 3 24 24 27 4 4 3 5 5 
5 5 5 4 4 4 4 4 3 24 3 24 24 25 24 24 26 24 24 27 24 3 25 24 24 24 24 3 5 5 
5 5 5 5 5 5 5 5 3 24 3 24 27 24 24 24 25 24 24 24 3 4 24 24 25 24 24 3 5 5 
5 5 5 5 5 5 5 5 3 24 3 24 24 24 24 24 24 24 4 4 4 24 24 24 24 24 24 3 5 5 
5 5 5 5 5 3 4 4 4 24 4 4 4 4 4 3 27 24 24 24 24 24 24 25 24 26 24 3 5 5 
5 5 3 4 4 4 24 24 24 24 24 24 24 24 24 4 3 3 3 24 24 25 24 24 24 24 24 3 5 5 
5 5 3 24 24 24 24 24 24 24 26 24 24 24 24 24 3 4 4 3 24 24 24 24 24 24 3 4 5 5 
5 5 3 24 24 24 24 24 24 24 24 24 24 24 24 24 3 5 5 3 3 24 24 24 24 3 3 5 5 5 
5 5 3 24 24 27 24 25 24 24 24 24 24 27 24 24 3 5 5 4 4 3 3 3 3 3 4 5 5 5 
5 5 3 24 24 24 24 24 24 26 24 24 24 24 24 24 3 5 5 5 5 4 4 4 4 4 5 5 5 5 
5 5 3 24 24 24 24 25 24 24 24 27 24 24 24 24 3 5 5 5 5 5 5 5 5 5 5 5 5 5 
5 5 3 3 24 24 24 24 24 24 24 24 24 24 24 3 3 5 5 5 5 5 5 5 5 5 5 5 5 5 
5 5 4 3 3 24 24 24 26 24 24 24 24 24 3 3 4 5 5 5 5 5 5 5 5 5 5 5 5 5 
5 5 5 3 3 3 24 24 24 24 24 24 3 3 3 4 5 5 5 5 5 5 5 5 5 5 5 5 5 5 
5 5 5 4 4 3 3 3 3 3 3 3 3 3 4 5 5 5 5 5 5 5 5 5 5 5 5 5 5 5 
5 5 5 5 5 4 4 4 4 4 4 4 4 4 5 5 5 5 5 5 5 5 5 5 5 5 5 5 5 5 
5 5 5 5 5 5 5 5 5 5 5 5 5 5 5 5 5 5 5 5 5 5 5 5 5 5 5 5 5 5 
--LAYER 1--
0 0 0 0 0 0 0 0 0 0 0 0 0 0 0 0 0 0 0 0 0 0 0 0 0 0 0 0 0 0 
1 1 1 1 1 1 1 1 1 1 1 1 1 1 1 1 1 1 1 1 1 1 1 1 1 1 1 1 1 1 
1 1 1 1 1 1 1 1 1 1 1 1 1 1 1 1 1 1 0 0 0 0 0 1 1 1 1 1 1 1 
1 1 1 1 0 1 1 1 0 1 1 1 1 1 1 1 1 0 0 0 0 0 0 0 0 0 1 1 1 1 
1 1 1 1 0 0 0 0 0 0 1 1 1 1 1 1 1 1 0 0 0 0 0 0 0 0 0 1 1 1 
1 1 1 0 0 0 0 0 0 0 0 0 0 0 0 1 1 1 0 0 0 0 0 0 0 0 0 1 1 1 
1 1 1 1 0 0 0 0 0 0 0 0 0 0 1 1 1 1 1 0 0 0 0 0 0 0 0 0 1 1 
1 1 1 1 0 0 0 0 0 0 0 0 0 0 1 1 1 1 1 0 0 0 0 0 0 0 0 0 0 1 
1 1 1 1 0 0 0 0 0 0 0 0 0 1 1 1 1 1 1 0 0 0 0 0 0 0 0 0 0 1 
1 1 1 1 0 0 0 0 0 0 0 0 1 1 1 1 1 1 1 0 0 0 0 0 0 0 0 0 1 1 
1 1 1 1 0 0 0 0 0 0 0 0 1 1 1 0 0 1 1 0 0 0 0 0 0 0 0 1 1 1 
1 1 1 0 0 0 0 0 0 0 0 0 0 0 0 0 0 0 0 0 0 0 0 0 0 0 1 1 1 1 
1 1 1 1 0 0 0 0 0 0 0 1 1 1 1 1 1 1 1 1 1 0 0 0 0 1 1 1 1 1 
1 1 1 1 1 1 1 1 1 0 1 1 0 0 0 0 0 0 0 0 1 1 0 0 0 1 1 1 1 1 
1 1 1 1 1 1 1 1 1 0 1 0 0 0 0 0 0 0 0 0 0 1 0 0 0 0 0 1 1 1 
1 1 1 1 1 1 1 1 1 0 1 0 0 0 0 0 0 0 0 0 1 1 0 0 0 0 0 1 1 1 
1 1 1 1 1 1 1 1 1 0 1 0 0 0 0 0 0 0 1 1 1 0 0 0 0 0 0 1 1 1 
1 1 1 1 1 1 1 1 1 0 1 1 1 1 1 1 0 0 0 0 0 0 0 0 0 0 0 1 1 1 
1 1 1 1 1 1 0 0 0 0 0 0 0 0 0 1 1 1 1 0 0 0 0 0 0 0 0 1 1 1 
1 1 1 0 0 0 0 0 0 0 0 0 0 0 0 0 1 1 1 1 0 0 0 0 0 0 1 1 1 1 
1 1 1 0 0 0 0 0 0 0 0 0 0 0 0 0 1 1 1 0 1 0 0 0 0 1 1 1 1 1 
1 1 1 0 0 0 0 0 0 0 0 0 0 0 0 0 1 1 1 1 1 1 1 1 1 1 1 1 1 1 
1 1 1 0 0 0 0 0 0 0 0 0 0 0 0 0 1 1 1 1 1 1 1 1 1 1 1 1 1 1 
1 1 1 0 0 0 0 0 0 0 0 0 0 0 0 0 1 1 1 1 1 1 1 1 1 1 1 1 1 1 
1 1 1 1 0 0 0 0 0 0 0 0 0 0 0 1 1 1 1 1 1 1 1 1 1 1 1 1 1 1 
1 1 1 1 1 0 0 0 0 0 0 0 0 0 1 1 1 1 1 1 1 1 1 1 1 1 1 1 1 1 
1 1 1 1 1 1 0 0 0 0 0 0 1 1 1 1 1 1 1 1 1 1 1 1 1 1 1 1 1 1 
1 1 1 1 1 1 1 1 1 1 1 1 1 1 1 1 1 1 1 1 1 1 1 1 1 1 1 1 1 1 
1 1 1 1 1 1 1 1 1 1 1 1 1 1 1 1 1 1 1 1 1 1 1 1 1 1 1 1 1 1 
1 1 1 1 1 1 1 1 1 1 1 1 1 1 1 1 1 1 1 1 1 1 1 1 1 1 1 1 1 1 
